7,7,7,7,7,7,7,7,7,7,7,7,7,7,7,
0,0,0,0,0,0,0,0,0,0,0,0,0,0,0,
2,2,2,2,3,6,1,2,2,2,2,3,6,1,2,
0,0,0,0,0,5,0,0,0,0,0,0,5,0,0,
2,2,3,6,1,2,2,2,3,6,1,2,2,2,2,
0,0,0,5,0,0,0,0,0,5,0,0,0,0,0,
2,2,3,5,1,2,2,2,2,2,2,2,3,6,1,
0,0,0,5,0,0,0,0,0,0,0,0,0,5,0,
2,2,2,2,2,2,3,6,1,2,2,3,6,1,2,
0,0,0,0,8,0,0,5,0,0,0,0,5,0,0,
4,4,4,4,4,4,4,4,4,4,4,4,4,4,4