7,7,7,7,7,7,7,7,7,7,7,7,7,7,7,
0,0,0,0,0,0,0,0,0,0,0,0,0,0,0,
2,2,2,6,2,2,2,2,2,2,2,6,2,2,2,
0,0,0,5,0,0,0,0,0,0,0,5,0,0,0,
2,2,2,2,2,6,2,2,2,6,2,2,2,2,2,
0,0,0,0,0,5,0,0,0,5,0,0,0,0,0,
2,2,2,2,2,2,2,6,2,2,2,2,2,2,2,
0,0,0,0,0,0,0,5,0,0,0,0,0,0,0,
2,2,2,6,2,2,2,2,2,2,2,6,2,2,2,
0,0,0,5,8,0,0,0,0,0,0,5,0,0,0,
4,4,4,4,4,4,4,4,4,4,4,4,4,4,4