0,0,0,0,0,0,0,0,0,0,0,0,0,0,0,
11,11,11,11,11,11,11,11,11,11,11,11,11,11,0,
0,0,0,0,0,0,0,0,0,0,0,0,0,0,0,
11,11,11,10,11,11,11,11,11,11,10,11,10,11,0,
0,0,0,0,0,0,0,0,0,0,0,0,0,0,0,
11,10,11,11,11,11,11,10,11,11,10,11,11,11,0,
0,0,0,0,0,0,0,0,0,0,0,0,0,0,0,
11,11,11,10,11,11,11,11,11,11,11,11,11,11,0,
0,0,0,0,0,0,0,0,0,0,0,0,0,0,0,
11,10,11,10,0,11,11,10,11,11,11,11,11,11,0,
0,0,0,0,0,0,0,0,0,0,0,0,0,0,0